8 8
S . . . . . . .
. # # # # # # .
. . . . . . . .
# # # . # # # .
. . . . . . . .
. # # # # # . .
. . . . . . . G
# # # # # # # #
