15 12
S . . . # . . . . . . . . . .
. # # . # . # # # # # # # . .
. . . . . . . . . . . . # . .
# # # # # # # . # # # . # . .
. . . . . . . . . . . . . . .
. # # # # # # # # # # # # # .
. . . . . . . . . . . . . . .
# # # . # # # # # # # . # # #
. . . . . . . . . . . . . . .
. # # # # # # . # # # # # . .
. . . . . . . . . . . . . . G
# # # # # # # # # # # # # # #
